1111111111
1P00A000C1
100C111A01
11A0C00001
1000000001
100A0000C1
1111001111
1E10100101
10000011A1
1111111111