1111111
1P00101
1C001C1
10A0101
100C001
1C00E11
1111111
