1111111111
1000000001
1000000001
1000000001
1000K0E001
1000000001
100C000E01
1000000P01
100C000001
1111111111
